?.........
##
#.#......%
.#.#.....#
#.#.#...#.
.#.#.#@#.#