.........@
.......###
......#.#.
.!#!######
.#.#
..?.....%!